#module 0 size: 18 bs: 1.79647e-101
7 10 13 17 18 22 28 31 33 37 38 41 44 45 47 50 51 56 
#module 1 size: 28 bs: 7.01661e-14
1 2 3 4 9 15 21 23 27 30 34 43 46 48 49 53 60 63 68 70 72 73 74 78 79 81 83 93 
#module 2 size: 35 bs: 0.000478335
5 11 16 25 32 35 36 40 57 61 62 64 69 75 76 77 80 82 84 85 86 87 88 89 90 91 92 93 94 95 96 97 98 99 100 
#module 3 size: 15 bs: 9.9698e-14
6 19 20 29 42 52 54 55 58 59 65 66 67 71 97 
#module 4 size: 51 bs: 0.0025921
203 206 208 210 212 216 217 218 222 223 224 225 226 230 232 234 237 239 242 243 244 245 247 248 249 253 254 256 259 262 263 264 265 266 267 270 272 274 276 277 282 284 285 286 288 289 291 294 295 296 297 
#module 5 size: 13 bs: 2.08752e-07
214 215 252 268 275 278 279 281 287 290 293 298 300 
#module 6 size: 13 bs: 7.96315e-07
124 135 145 154 161 167 179 182 184 185 187 188 200 
#module 7 size: 47 bs: 0.00955756
102 107 111 112 117 119 120 125 126 127 128 130 132 133 134 137 138 150 152 153 156 157 158 162 165 168 169 170 171 172 174 177 180 181 186 189 190 191 192 193 194 195 196 197 198 199 200 
#module 8 size: 26 bs: 0.0109653
103 106 114 116 121 123 136 139 140 141 142 143 144 146 147 148 149 151 155 159 160 166 171 175 176 183 
#module 0 size: 18 bs: 4.62303e-101
7 10 13 17 18 22 28 31 33 37 38 41 44 45 47 50 51 56 
#module 1 size: 28 bs: 7.01661e-14
1 2 3 4 9 15 21 23 27 30 34 43 46 48 49 53 60 63 68 70 72 73 74 78 79 81 83 93 
#module 2 size: 35 bs: 0.000478335
5 11 16 25 32 35 36 40 57 61 62 64 69 75 76 77 80 82 84 85 86 87 88 89 90 91 92 93 94 95 96 97 98 99 100 
#module 3 size: 15 bs: 9.9698e-14
6 19 20 29 42 52 54 55 58 59 65 66 67 71 97 
#module 4 size: 13 bs: 0.00988883
124 135 145 154 161 167 179 182 184 185 187 188 200 
#module 5 size: 41 bs: 0.0109652
107 111 112 117 120 125 127 128 130 132 133 137 138 150 152 153 156 157 158 162 165 168 169 171 172 174 177 180 181 186 189 190 191 192 193 194 195 196 197 198 199 
#module 6 size: 26 bs: 2.51241e-07
103 106 114 116 121 123 136 139 140 141 142 143 144 146 147 148 149 151 155 159 160 166 171 175 176 183 
#module 7 size: 100 bs: 3.92827e-101
201 202 203 204 205 206 207 208 209 210 211 212 213 214 215 216 217 218 219 220 221 222 223 224 225 226 227 228 229 230 231 232 233 234 235 236 237 238 239 240 241 242 243 244 245 246 247 248 249 250 251 252 253 254 255 256 257 258 259 260 261 262 263 264 265 266 267 268 269 270 271 272 273 274 275 276 277 278 279 280 281 282 283 284 285 286 287 288 289 290 291 292 293 294 295 296 297 298 299 300 
