#module 0 size: 10 bs: 0.0404795
1 6 35 40 65 66 70 74 79 84 
#module 1 size: 15 bs: 0.0594954
2 13 14 46 53 57 59 76 77 78 80 89 91 92 93 
#module 2 size: 18 bs: 0.00764839
3 5 7 9 16 22 25 26 28 30 34 41 50 60 71 73 95 98 
#module 3 size: 15 bs: 0.0522206
12 18 24 56 58 63 67 69 82 83 88 94 96 99 100 
#module 4 size: 11 bs: 0.0127875
17 20 23 31 43 47 48 55 62 65 69 
#module 5 size: 17 bs: 0.0565452
4 8 21 29 32 38 39 44 51 52 61 64 67 72 75 81 85 
#module 6 size: 19 bs: 0.00605926
10 11 15 19 33 36 37 42 45 46 49 54 68 81 86 87 89 90 97 
#module 0 size: 10 bs: 0.0404796
1 6 35 40 65 66 70 74 79 84 
#module 1 size: 15 bs: 0.0594955
2 13 14 46 53 57 59 76 77 78 80 89 91 92 93 
#module 2 size: 18 bs: 0.0406777
3 5 7 9 16 22 25 26 28 30 34 41 50 60 71 73 95 98 
#module 3 size: 15 bs: 0.0273607
12 18 24 56 58 63 67 69 82 83 88 94 96 99 100 
#module 4 size: 11 bs: 0.063534
17 20 23 31 43 47 48 55 62 65 69 
#module 5 size: 17 bs: 0.0565452
4 8 21 29 32 38 39 44 51 52 61 64 67 72 75 81 85 
#module 6 size: 19 bs: 0.00605927
10 11 15 19 33 36 37 42 45 46 49 54 68 81 86 87 89 90 97 
#module 0 size: 10 bs: 0.0404795
1 6 35 40 65 66 70 74 79 84 
#module 1 size: 15 bs: 0.0594955
2 13 14 46 53 57 59 76 77 78 80 89 91 92 93 
#module 2 size: 18 bs: 0.0522206
3 5 7 9 16 22 25 26 28 30 34 41 50 60 71 73 95 98 
#module 3 size: 15 bs: 0.0814075
12 18 24 56 58 63 67 69 82 83 88 94 96 99 100 
#module 4 size: 11 bs: 0.00218686
17 20 23 31 43 47 48 55 62 65 69 
#module 5 size: 16 bs: 0.00796273
4 8 21 29 32 38 39 44 51 52 61 64 72 75 81 85 
#module 6 size: 11 bs: 0.063534
10 19 33 37 42 45 46 49 54 90 97 
#module 7 size: 8 bs: 0.0414905
15 36 68 81 86 87 89 97 
#module 0 size: 10 bs: 0.0404796
1 6 35 40 65 66 70 74 79 84 
#module 1 size: 15 bs: 0.0594954
2 13 14 46 53 57 59 76 77 78 80 89 91 92 93 
#module 2 size: 18 bs: 0.0522206
3 5 7 9 16 22 25 26 28 30 34 41 50 60 71 73 95 98 
#module 3 size: 15 bs: 0.0406777
12 18 24 56 58 63 67 69 82 83 88 94 96 99 100 
#module 4 size: 11 bs: 0.00218687
17 20 23 31 43 47 48 55 62 65 69 
#module 5 size: 19 bs: 0.00605925
10 11 15 19 33 36 37 42 45 46 49 54 68 81 86 87 89 90 97 
#module 6 size: 17 bs: 0.0565451
4 8 21 29 32 38 39 44 51 52 61 64 67 72 75 81 85 
#module 0 size: 10 bs: 0.0404795
1 6 35 40 65 66 70 74 79 84 
#module 1 size: 15 bs: 0.0594955
2 13 14 46 53 57 59 76 77 78 80 89 91 92 93 
#module 2 size: 18 bs: 0.063534
3 5 7 9 16 22 25 26 28 30 34 41 50 60 71 73 95 98 
#module 3 size: 10 bs: 0.0406777
4 32 38 39 44 64 72 75 81 85 
#module 4 size: 15 bs: 0.0209446
12 18 24 56 58 63 67 69 82 83 88 94 96 99 100 
#module 5 size: 8 bs: 0.0406777
8 21 29 51 52 61 67 85 
#module 6 size: 6 bs: 0.0448197
31 43 47 55 62 66 
#module 7 size: 11 bs: 0.0635341
10 19 33 37 42 45 46 49 54 90 97 
#module 8 size: 9 bs: 0.00218687
11 15 36 68 81 86 87 89 97 
#module 0 size: 10 bs: 0.0404797
1 6 35 40 65 66 70 74 79 84 
#module 1 size: 15 bs: 0.0594956
2 13 14 46 53 57 59 76 77 78 80 89 91 92 93 
#module 2 size: 18 bs: 0.0814076
3 5 7 9 16 22 25 26 28 30 34 41 50 60 71 73 95 98 
#module 3 size: 15 bs: 0.0775048
12 18 24 56 58 63 67 69 82 83 88 94 96 99 100 
#module 4 size: 6 bs: 0.0300021
31 43 47 55 62 66 
#module 5 size: 19 bs: 0.0123172
10 11 15 19 33 36 37 42 45 46 49 54 68 81 86 87 89 90 97 
#module 6 size: 9 bs: 0.0868266
4 32 38 39 44 64 72 75 81 
#module 7 size: 8 bs: 0.0448196
8 21 29 51 52 61 67 85 
#module 0 size: 10 bs: 0.0404796
1 6 35 40 65 66 70 74 79 84 
#module 1 size: 15 bs: 0.0594957
2 13 14 46 53 57 59 76 77 78 80 89 91 92 93 
#module 2 size: 18 bs: 0.0522206
3 5 7 9 16 22 25 26 28 30 34 41 50 60 71 73 95 98 
#module 3 size: 15 bs: 0.0522206
12 18 24 56 58 63 67 69 82 83 88 94 96 99 100 
#module 4 size: 11 bs: 0.0448197
17 20 23 31 43 47 48 55 62 65 69 
#module 5 size: 19 bs: 0.0123172
10 11 15 19 33 36 37 42 45 46 49 54 68 81 86 87 89 90 97 
#module 6 size: 17 bs: 0.0565452
4 8 21 29 32 38 39 44 51 52 61 64 67 72 75 81 85 
#module 0 size: 10 bs: 0.0404796
1 6 35 40 65 66 70 74 79 84 
#module 1 size: 15 bs: 0.0594955
2 13 14 46 53 57 59 76 77 78 80 89 91 92 93 
#module 2 size: 18 bs: 0.0522206
3 5 7 9 16 22 25 26 28 30 34 41 50 60 71 73 95 98 
#module 3 size: 15 bs: 0.0814076
12 18 24 56 58 63 67 69 82 83 88 94 96 99 100 
#module 4 size: 11 bs: 0.00218687
17 20 23 31 43 47 48 55 62 65 69 
#module 5 size: 11 bs: 0.0635341
10 19 33 37 42 45 46 49 54 90 97 
#module 6 size: 8 bs: 0.0414905
15 36 68 81 86 87 89 97 
#module 7 size: 17 bs: 0.0565451
4 8 21 29 32 38 39 44 51 52 61 64 67 72 75 81 85 
#module 0 size: 10 bs: 0.0404796
1 6 35 40 65 66 70 74 79 84 
#module 1 size: 15 bs: 0.0594957
2 13 14 46 53 57 59 76 77 78 80 89 91 92 93 
#module 2 size: 18 bs: 0.0522206
3 5 7 9 16 22 25 26 28 30 34 41 50 60 71 73 95 98 
#module 3 size: 15 bs: 0.0406777
12 18 24 56 58 63 67 69 82 83 88 94 96 99 100 
#module 4 size: 6 bs: 0.00218686
31 43 47 55 62 66 
#module 5 size: 17 bs: 0.0565452
4 8 21 29 32 38 39 44 51 52 61 64 67 72 75 81 85 
#module 6 size: 19 bs: 0.0123172
10 11 15 19 33 36 37 42 45 46 49 54 68 81 86 87 89 90 97 
#module 0 size: 10 bs: 0.0404796
1 6 35 40 65 66 70 74 79 84 
#module 1 size: 15 bs: 0.0594956
2 13 14 46 53 57 59 76 77 78 80 89 91 92 93 
#module 2 size: 18 bs: 0.0406777
3 5 7 9 16 22 25 26 28 30 34 41 50 60 71 73 95 98 
#module 3 size: 15 bs: 0.0522207
12 18 24 56 58 63 67 69 82 83 88 94 96 99 100 
#module 4 size: 11 bs: 0.0448196
17 20 23 31 43 47 48 55 62 65 69 
#module 5 size: 11 bs: 0.0635341
10 19 33 37 42 45 46 49 54 90 97 
#module 6 size: 7 bs: 0.0602874
15 36 68 86 87 89 97 
#module 7 size: 16 bs: 0.00796274
4 8 21 29 32 38 39 44 51 52 61 64 72 75 81 85 
